@ @ @ @ @ @ * * * @
@ @ @ @ @ * * * * @
@ @ @ @ @ @ * * * @
@ @ @ @ @ @ @ * * @
@ @ @ @ @ @ @ @ * @