@ @ @ @ @ @ . . . @
@ @ @ @ @ . . . . @
@ @ @ @ @ @ . . . @
@ @ @ @ @ @ @ . . @
@ @ @ @ @ @ @ @ . @